111111
100001
10C111
1000M1
100P01
10E111
1000C1
111111