111111111111111111111111111111111111111111111111111111111111111111111111111111111111
10C0000001C1000000111111111111111111111111111111111111111111111111111111111111111111
1000000000010M0000111111111111111111111111111111111111111111111111111111111111111111
1000000M0000000000111111111111111111111111111111111111111111111111111111111111111111
100000000000000000111111111111111111111111111111111111111111111111111111111111111111
1000C0000000000M00111111111111111111111111111111111111111111111111111111111111111111
1000000000C0000000111111111111111111111111111111111111111111111111111111111111111111
100000000000000000111111111111111111111111111111111111111111111111111111111111111111
100000000000010101111111111111111111111111111111111111111111111111111111111111111111
1000000000P001E100111111111111111111111111111111111111111111111111111111111111111111
100000000000010100111111111111111111111111111111111111111111111111111111111111111111
100000000000011100011111111111111111111111111111111111111111111111111111111111111111
111111111111111111111111111111111111111111111111111111111111111111111111111111111111